78888888888888888888888888888888888888888888888888888888888888888888888888888888888888888888888888888888888888888888889
4---------------------------------------------------------------------------------------------------------------------6
4------------------------------------------------RRR------------------------------------------------------------------6
4---------------------------------------------------------------------------------------------------------------------6
4------------------------------------------RRR------------------------------------------------------------------------6
4---------------------------------------------------------------------------------------------------------------------6
4---------------------------------------------------------------------------------------------------------------------6
4---------------------------------------------------------------------------------------------------------------------6
4---------------------------------------------------BBBB----BBBB------------------------------------------------------6
4---------------------------------------------------BBBB----BBBB------------------------------------------------------6
4---------------------------------------------------BBBB----BBBB------------------------------------------------------6
4--------------x------------------------------------BBBB----BBBB------------------------------------------------------6
4---------------------------------------------------------------------------------------------------------------------6
4---------------------------------------------------------------------------------------------------------------------6
4---------------------------------------------------------------------------------------------------------------------6
4---------------------------------------------------------------------RRR---------------------------------------------6
4---------------------------------------------------------------------------------------------------------------------6
4---------------------------------------------------------------RRR---------------------------------------------------6
4---------------------------------------------------------------------------------------------------------------------6
12222222222222222222222222222222222222222222222222222222222222222222222222222222222222222222222222222222222222222222223