\\\\\\\\\\\\\\\\\\\\\\\\\\\\\\\\\\\\\\\\\\\\\\\\\\\\\\\\\\\\\\\\\\\\\\\\\\\\\\\\\\\\\\\\\\\\\\\\\\\\\\\\\\\\\\\\\\\\\\\\\\\\\\\
\-----------------------------------------------------------------------------------------------------------------------------\
\------y----------------------------------------------------------------------------------------------------------------------\
\-----------------------------------------------------------------------------------------------------------------B-----------\
\-----------------------------------------------------------------------------------------------------------------------------\
\-----------------------------------------------------------------------------------------------------------------------------\
\-----------------------------------------------------------------------------------------------------------------------------\
\-----------------------------------------------------------------------------------------------------------------------------\
\-------------------------------------------------B---------------------------B----------------------------------B------------\
\-----------------------------------------------------------------------------------------------------------------------------\
\-----------------------------------------------------------------------------------------------------------------------------\
\---------------------------------------------------------------------------------------------------------------B-------------\
\-----------------------------------------------------------------------------------------------------------------------------\
\---------B-------------------------------B-----------------B----------------------------------B---------------B--------------\
\-----------------------------------------------------------------------------------------------------------------------------\
\-----------------------------------------------------------------------------------------------------------------------------\
\------B----------------------------------------------------------------------------------------------------------------------\
\-----------------------------------------------------------------------------------------------------------------------------\
\-----------------------------------------------------------------------------------------------------------------------------\
\-----------------------------------------------------------------------------------------------------------------------------\
\-----------------------------------------------------------------------------------------------------------------------------\
\-----------------------------------------------------------------------------------------------------------------------------\
\---------------------------------------------------B-------------------------B-----------------------------------------B-----\
\-----------------------------------------------------------------------------------------------------------------------B-----\
\---------------------BBBBB---------------------------------------------------------------------------------------------B-----\
\---------------------B---B---------------------------------B-B-B-B-B-B-B-B-B-B-B-B-B-B-B-B-B-B-B-B-B-B-B-B-B-B-B-B-B-B-B-----\
\---------------------BBBBB---------------------------------------------------------------------------------------------------\
\-----------------------------------------------------------------------------------------------------------------------------\
\-----------------------------------------------------------------------------------------------------------------------------\
\-----------------------------------------------------------------------------------------------------------------------------\
\-----------------------------------------------------------------------------------------------------------------------------\
\-----------------------------------------------------------------------------------------------------------------------------\
\-----------------------------------------------------------------------------------------------------------------------------\
\-----------------------------------------------------------------------------------------------------------------------------\
\----------------------------------------------------------BB-----------------------------------------------------------------\
\----------------------------------------------------------BB-----------------------------------------------------------------\
\-----------------------------------------------------------------------------------------------------------------------------\
\-----------------------------------------------------------------------------------------------------------------------------\
\-----------------------------------------------------------------------------------------------------------------------------\
\-----------------------------------------------------------------------------------------------------------------------------\
\-----------------------------------------------------------------------------------------------------------------------------\
\-----------------------------------------------------------------------------------------------------------------------------\
\-----------------------------------------------------------------------------------------------------------------------------\
\-----------------------------------------------------------------------------------------------------------------------------\
\-----B-B-B-B-B-B-B-B-B-B-B-B-B-B-B-B-B-B-B-B-B-B-B-B-B----------------------------------------------BBBBBB-------------------\
\-----B----------------------------------------------------------------------------------------------B----B-------------------\
\-----B----------------------------------------------------------------------------------------------BBBBBB-------------------\
\-----B-----------------------------------------------------------------------------------------------------------------------\
\-----------------------------------------------------------------------------------------------------------------------------\
\-----------------------------------------------------------------------------------------------------------------------------\
\-----------------------------------------------------------------------------------------------------------------------------\
\-----------------------------------------------------------------------------------------------------------------------------\
\-----------------------------------------------------------------------------------------------------------------------------\
\-----------------------------------------------------------------------------------------------------------------------------\
\-----------------------------------------------------------------------------------------------------------------------------\
\----------------------------------------------------------------------------------B------------------------------------------\
\---------------------------------------B-----------B-------------------------------------------------------------------------\
\-----------------------------------------B-------B---------------------------------------------------------------------------\
\-------------------------------------------B---B-----------------------------------------------------------------------------\
\---------------------------------------------B---------------------------------B---------------------------------------------\
\-------------------------------------------B---B-----------------------------------------------------------------------------\
\-----------------------------------------B-------B---------------------------------------------------------------------------\
\---------------------------------------B-----------B-------------------------B-----------------------------------------------\
\------------------------------------------------------------------------------------------------------------B----------------\
\-----------------------------------------------------------------------------------------------------------------------------\
\-----------------------------------------------------------------------------------------------------------------------------\
\-----------------------------------------------------------------------------------------------------------------------------\
\--------------------------------------------------------------------------------------------------------x--------------------\
\-----------------------------------------------------------------------------------------------------------------------------\
\-----------------------------------------------------------------------------------------------------------------------------\
\-----------------------------------------------------------------------------------------------------------------------------\
\\\\\\\\\\\\\\\\\\\\\\\\\\\\\\\\\\\\\\\\\\\\\\\\\\\\\\\\\\\\\\\\\\\\\\\\\\\\\\\\\\\\\\\\\\\\\\\\\\\\\\\\\\\\\\\\\\\\\\\\\\\\\\\