\\\\\\\\\\\\\\\\\\\\\\\\\\\\\\\\\\\\\\\\\\\\\\\\\\\\\\\\\\\\\\\\\\\\\\\\\\\\\\\\\\\\\\\\\\\\\\\\\\\\\\\\\\\\\\\\\\\\\\\\\\\\\\\
\-----------------------------------------------------------------------------------------------------------------------------\
\------y----------------------------------------------------------------------------------------------------------------------\
\-----------------------------------------------------------------------------------------------------------------------------\
\-----------------------------------------------------------------------------------------------------------------------------\
\-----------------------------------------------------------------------------------------------------------------------------\
\-----------------------------------------------------------------------------------------------------------------------------\
\---------------------------------------------------------B-------------------------------------------------------------------\
\------------------------B----------------------------------------------------------------------------------------------------\
\------------------------------------------------------------------------------------------------------B----------------------\
\-----------------------------------------------------------------------------------------------------------------------------\
\---------------------------------------------------------------------B-------------------------------------------------------\
\-----------------------------------------------B-----------------------------------------------------------------------------\
\--------------B----------------------------------------------------------------------------------------------B---------------\
\-------------------------------------------------------------------B---------------------------------------------------------\
\--------------B-----------------------------------B----------------------------------------------------------B---------------\
\------------------------------------------------------------------------------------B----------------------------------------\
\--------------B----------------------------------------------------------------------------------------------B---------------\
\-----------------------------------------------------------------------------------------------------------------------------\
\--------------B----------------------------------------------------------------------------------------------B---------------\
\-----------------------------------------------------------------------------------------------------------------------------\
\--------------B----------------------------------------------------------------------------------------------B---------------\
\------------------------------------B----------------------------------------------------------------------------------------\
\--------------B----------------------------------------------------------------------------------------------B---------------\
\-------------------------------------------------------------B---------------------------------------------------------------\
\--------------B----------------------------------------------------------------------------------------------B---------------\
\-----------------------------------------------------------------------------------------------------------------------------\
\--------------B----------------------------------------------------------------------------------------------B---------------\
\-----------------------------------------------------------------------------------------------------------------------------\
\--------------B----------------------------------------------------------------------------------------------B---------------\
\-----------------------------------------------------------------------------------------------------------------------------\
\--------------B----------------------------------------------------------------------------------------------B---------------\
\------------------------------------B-B-B-B-B-B-B-B-B-B-------------B-B-B-B-B-B-B-B-B-B--------------------------------------\
\--------------B----------------------------------------------------------------------------------------------B---------------\
\-----------------------------------------------------------------------------------------------------------------------------\
\--------------B----------------------------------------------------------------------------------------------B---------------\
\-----------------------------------------------------------------------------------------------------------------------------\
\--------------B----------------------------------------------------------------------------------------------B---------------\
\-----------------------------------------------------------------------------------------------------------------------------\
\--------------B----------------------------------------------------------------------------------------------B---------------\
\------------------------------------B-B-B-B-B-B-B-B-B-B-------------B-B-B-B-B-B-B-B-B-B--------------------------------------\
\--------------B----------------------------------------------------------------------------------------------B---------------\
\-----------------------------------------------------------------------------------------------------------------------------\
\--------------B----------------------------------------------------------------------------------------------B---------------\
\-----------------------------------------------------------------------------------------------------------------------------\
\--------------B----------------------------------------------------------------------------------------------B---------------\
\-----------------------------------------------------------------------------------------------------------------------------\
\--------------B----------------------------------------------------------------------------------------------B---------------\
\-----------------------------------------------------------------------------------------------------------------------------\
\--------------B----------------------------------------------------------------------------------------------B---------------\
\-----------------------------------------------------------------------------------------------------------------------------\
\--------------B----------------------------------------------------------------------------------------------B---------------\
\-----------------------------------------------------------------------------------------------------------------------------\
\--------------B------------------B----------------B----------------------------------------------------------B---------------\
\------------------------------------------------------------B--------B-------------------------------------------------------\
\--------------B----------------------------------------------------------------------------------------------B---------------\
\-----------------------------------------------------------------------------------------------------------------------------\
\--------------B----------------------------------------------------------------------------------------------B---------------\
\-------------------------------------------------------------------------------------B---------------------------------------\
\--------------B-------------------------------------------------B--------------------------------------------B---------------\
\-----------------------------------B-----------------------------------------------------------------------------------------\
\-----------------------------------------------------------------------------------------------------------------------------\
\-----------------------------------------------------------------------------------------------------------------------------\
\-----------------------------------------------------------------------------------------------------------------------------\
\-----------------------------------------------------------------------------------------------------------------------------\
\-----------------------------------------------------------------------------------------------------------------------------\
\--------------------------------------------------B--------------------------------------------------------------------------\
\------------------------------------------------------------------------------------B----------------------------------------\
\---------------------------------------------------------------------------------------------------------------------x-------\
\-----------------------------------------------------------------------------------------------------------------------------\
\-----------------------------------------------------------------------------------------------------------------------------\
\\\\\\\\\\\\\\\\\\\\\\\\\\\\\\\\\\\\\\\\\\\\\\\\\\\\\\\\\\\\\\\\\\\\\\\\\\\\\\\\\\\\\\\\\\\\\\\\\\\\\\\\\\\\\\\\\\\\\\\\\\\\\\\